eingebaute Funktionen, ohne Aufruf von Modulen:

    abs() -> Liefert den Betrag einer Zahl
    bin() -> Liefert eine binäre bzw. duale Zahl
    bytes() -> Liefert ein objekt des Datentyps
    chr() -> Liefert ein Zeichen zu einer Unicode-Zahl
    eval() -> Liefert einen ausgeführten Python-Ausdruck
    exec() -> Führt eine Anwendung aus
    filter() -> Liefert die Elemente eines iterierbaren Objektes, für die eine Funktion True ergibt
    float() -> Liefert eine Zahl mit Nachkommastellen
    format() -> Formatiert Zahlen und Zeichenketten
    frozenset() -> Formatiert Zahlen und Zeichenketten
    hex() -> Liefert eine hexadezimale Zahl
    input() -> Wratet auf eine EIngabe des Benutzers
    int() -> Liefert eine ganze Zahl
    len() -> Liefert die Anzahl der Elemente
    map() -> Liefert Funktionsergebnisse zu einer Reihe von Aufrufen
    max() -> Liefert das größte Element
    min() -> Liefert das kleinste Element
    oct() -> Liefert eine oktale Zahl
    open() -> Öffnet eine Datei zum Lesen oder Schreiben
    ord() -> Liefertdie Unicode-Zahl zu einem Zeichen
    print() -> Erzeugt eine Ausgabe
    range() -> Liefert ein iteriebares Objekt
    reversed() -> Liefert ein iteriebares Objekt in umgekehrter Reihenfolge
    repr() -> Liefert Informationen über ein Objekt
    round() -> Liefert eine gerundete Zahl
    set() -> Liefert ein set
    sorted() -> Liefert eine sortierte Liste
    str() -> Liefert eine Zeichenkette
    sum() -> Liefert die Summe der Elemente
    type() -> Liefert den Typ eines Objekts
    zip() -> Verbindet Element aus iterierbaren Objekten